HAAR	haar	ORTH
DAUBECHIES	db	ORTH
COIFLETS	coif	ORTH
SYMLETS	sym	ORTH
SPLINE_BIORTH	bior	BIORTH
SPLINE_RBIORTH	rbior	BIORTH
BEYLKIN	beylkin	ORTH
VAIDYANATHAN	vaidyanathan	ORTH
DMEY	dmey	ORTH
BATHLETS	bath	ORTH
LEGENDRE	legd	ORTH
FARRAS	fa	ORTH
KINGSBURYQ	ksq	ORTH
SINUS	sinus	REAL
POISSON	poisson	REAL
MEXICAN_HAT	mexh	REAL
MORLET	morl	REAL
DOGAUSS	DOG	REAL
GAUSS	gaus	REAL
CMORLET	cmor	COMPLEX
SHANNON	shan	COMPLEX
FBSP	fbsp	COMPLEX
CAUCHY	cauchy	COMPLEX
CGAUSS	cgau	COMPLEX
